11111111111111
10000000000001
10000P00000001
10000000000001
1000E000000001
100000000C0001
11111111111111