1111111111
1111111111
1111111111
1111111111
10EP00C001
1100010011
10      01
1111111111
1111111111
1111111111
1111110111
1111111111
1111111111