111111
1P1001
111101
1C0E01
111111
