11111111111111111111
11110000000000001111
10000000000000000001
10000000000000000011
1                  1
10000000000000000001
100000000  000000001
11110000000000000111
100000PEC00000000011
11111111111111111111