11111
1P001
1CP01
1EE11
11111
