1111111111
1P00000C01
1001111001
1C00X000E1
1111011111
1X000000X1
1111111111
