11111
1P0P1
1C0E1
11111
    1
